
R 1000  10000
SO    images/sprite.Xpm


NO    ./images/sprite.xpm
WE    ./images/stone.xpm

EA    ./images/stone1.xpm
S     ./images/sprite.xpm
F     42,000000005,000000000000000000002
C     00000000000000,000000255,0000000255


111111111111111111111111111111111111111111111
122222222222222222222200000000000000000000001
122222222222222222222200000000000000000000001
122222222222222222222200000000000000000000001
122222222222222222222200000000000000000000001
11111111111111111111111111111111111111111111
       1
11111111111111111111111111111111111111111111
1222222222222222222222000000000000000N0000001
122222222222222222222200000000001000000000001
122222222222222222222200000000010100000000001
122222222222222222222200000000001000000000001
122222222222222222222200000000000000000000001
100000000000000000000000000100000000000000001
111111111111111111111111111111111111111111111