R     1323 1433546546546546546545646546544654462
SO    ./images/txt64-2.xpm
NO    ./images/txt64-3.xpm
WE    ./images/txt64-4.xpm
C       0,1,255
EA    ./images/txt64-1.xpm
S     ./images/s.xpm
F     0,55,255

        1111111111111111111111111               1
        1000000000110000000N00001              101
        1111111111111111111111111               1