R      1456 777



NO    ./images/txt64-3.xpm
SO    ./images/txt64-2.xpm



WE    ./images/txt64-4.xpm

C   0,55,255

EA    ./images/txt64-1.xpm      
S     ./images/s.xpm

F     0,55,255


    1111111111111111111111111111111111111111               
      100000000000000000000000000000000000111111111111
    111111111111111111111111000000N000000000111111   
    1000000011111111000000000000000000000000011111111
    1000000000000000000000000000000000000000000111111
1100000000000000000000000020000000000000000011111
1000000000000000000000000000000000000000000001111
111111111111111111100000000000000000001111111    111
                 1000000000000000000000000000111111111111111111111
1111111111111111111110000000111111111111111111111
1111111111111111111100000000111111111111111111111
1000000000000000000100000000100000000000000000001
1000000000000000000000000000000000000000000000001
1000000000000000000100000000100000000000000000001
1111111111111111111111011111111111111111111111111
1111111       1111111111111100011111111111111           11111111111     11111111
11111111      1111111111100000011111111111111111111
111111111       11111111100000000100000001111111111111
111111111111111100000000000100000011111111111111111
111111111111111000000000000010000011111111         
111           111111111111000000000111111111111        
1111111111111111111111111111111111111111111111111111111111