R     2000 1100
SO    ./images/txt64-2.xpm
NO    ./images/txt64-3.xpm
WE    ./images/txt64-4.xpm
C      0,1,255
EA    ./images/txt64-1.xpm
S     ./images/s.xpm
F     0,55,255

1111111111111111111111111
11101000000000000000000001
11101000000000010000000001
111010000000N0001000000001
11101000000002000000000021
11101000000000000000000021
11101000000000000000000021
11101000000000000000000021
10000000000121212121210001
11111111111111111111111111
1 1 1 1 1 1 1 1 1 1 1 1