


           R 800  800       
SO    ./textures/bluestone.Xpm


NO    ./textures/colorstone.xpm
WE    ./textures/eagle.xpm

EA    ./textures/wood.xpm
S     ./textures/sprite.xpm
F     42,000000005,000000000000000000002
C     00000000000000,000000255,0000000255

11111
110W01                   
111111
