R     960 704 
SO    ./images/txt64-2.xpm
NO    ./images/txt64-3.xpm
WE    ./images/txt64-4.xpm
C       0,1,255
EA    ./images/txt64-1.xpm
S     ./images/s.xpm
F     0,55,255

        1111111111111111111111111              11
 1      100000000011000000000N01              101
11111111111111111111111111111111        111111111