
           R 00000008000  0000008000       
SO    ./textures/bluestone.Xpm


NO    ./textures/colorstone.xpm
WE    ./textures/eagle.xpm

EA    ./textures/wood.xpm
S     ./textures/bar.xpm
F     42,000000005,000000000000000000002
C     00000000000000,000000255,0000000255

                                         11111
                                        11020111111111
11111111111111111                       11000000000001
100000000000000011111111111111111111111111020200200021
102000002000002000000000000000000000000000000000000001
100000000000000011111111111111111111111111111111111111
10002000200020001
10000000000000001
10202020N02020201
10000000000000001
10002000200200001
10000000000000001
10200000200002001
10000000000000001
11111011111111111
    101
11111011111111111
10000000000000001
10200000200000201
10000000000000001
10002000200020001
10000000000000001
10202020002020201
10000000000000001
10002000200200001
10000000000000001
10200000200002001
10000000000000001
11111111111111111