R   1230 913
SO    ./images/texture2.xpm
NO    ./images/texture3.xpm
WE    ./images/texture4.xpm
C      135,206,235
EA    ./images/texture1.xpm
S     ./images/sprite.xpm
F     207,197,195

111111111111111111111111111111111111   
100000000000000000000000000000000001111111
120010000000200000000000000000000001
10001000100000000000000000000000001
100000000000000000000000000000000001
120202220200200000000000000000000001
10000000000000000000000000000000001
100000000000000000000000011000000001 1 11 
1200000000002000000000200011100000001
1000000000000000100202000000000W000001  
1000000000000000100000020000002000001
100000000000001100000000000000020001
100000000001110000000010000200000001
100011000200002000001100000000200001
100001020002000000000000000000000001
100001000000002001000000000000000001
100000000200200000000000000010000001
102002000000000110000000000000100001
100000000002000000000000000000000001
 1111111111111111111111111111111111 1 