R    12313222 213213
SO    ./images/texture2.xpm
NO    ./images/texture3.xpm
WE    ./images/texture4.xpm
C      135,206,235
EA    ./images/texture1.xpm
S     ./images/sprite.xpm
F     90,95,57

111111111111111
1110100000001111111
111111111110000001
1111111000101000001
11     11100011N111
1011111001101010111
111111110010111111
101111111110111111
11111111111111111111111