R     960 704 
SO    ./images/txt64-2.xpm
NO    ./images/txt64-3.xpm
WE    ./images/txt64-4.xpm
C       0,1,255
EA    ./images/txt64-1.xpm
S     ./images/s.xpm
F     0,55,255

111111111111111
100000000000101
100101000100101
111110000010101
1000000N0010101
100010000000001
100111111111001
100000000000001
100000000000001
100000010000001
111111111111111