R     0 777
NO    ./images/txt64-3.xpm
SO    ./images/txt64-2.xpm
WE    ./images/txt64-4.xpm
C   0,55,255
EA    ./images/txt64-1.xpm      
S     ./images/s.xpm
F     0,55,255

    1111111111 11     
      10000111 111            
    1111110001111     111
    1N0001111111
    1111111111111                 
1111100000000001111     111 
    11111111111111111              