R 14564684646546546500 10045454534354355435200010


SO    images/blue.Xpm


NO    ./images/sprite.xpm
WE    ./images/stone.xpm

EA    ./images/red.xpm
S     ./images/sprite.xpm
F     2,5,255
C     55,255,255

                    
 11111111111111111
10000000000000000N1 
 100000000000000001
 111111111111111111
11111111111111