R     0 777
NO    ./images/txt64-3.xpm
SO    ./images/txt64-2.xpm
WE    ./images/txt64-4.xpm
C   0,55,255
EA    ./images/txt64-1.xpm      
S     ./images/s.xpm
F     0,55,255

    111111111111     
      100000111111
    1111110000111     111
    100000001111111   
111110000N00000001111     111 
1100000000000000011111
10000000000000111111
1111111111111111      
