R    720 900
SO    ./images/txt64-2.xpm
NO    ./images/txt64-3.xpm
WE    ./images/txt64-4.xpm
C      135,206,235
EA    ./images/txt64-1.xpm
S     ./images/s.xpm
F     90,95,57

11111111111
11101000N11
1111111111